SS_QQQ_SS
QQ_NNN_QQ
Q__E_E__Q
_NNNNNNN_
_N_SSS_N_
_N_N_N_N_
___E_E___