SE_QQQ_ES
SQQQQQQQS
S_N_S_N_S
___E_E___
__N_S_N__
_Q_NNN_Q_
_E_____E_