_SSSSSSS_
_N_QQQ_N_
_N_E_E_N_
_Q_N_N_Q_
_Q_____Q_
_E_SSS_E_
___NNN___