_QQ_S_QQ_
_QN_N_NQ_
_Q_NNN_Q_
__E_S_E__
___NNN___
___________
_N_____N_