___________
 _NN_N_NN_
 _N_NNN_N_
 ___NEN___
 ___NNN___
 ____N____
___________